1111222333444
1000000000001
10X0002000001
1000000000001
1000000000001
1111222333444
